


















NO ./texture/path_to_the_south_texturea                                                       

SO    ./texture/path_to_the_south_texturea   

      WE ./texture/path_to_the_west_textureC 
                                
                                   
EA        ./texture/path_to_the_west_textureD

      F 55      ,  11 ,  200

      C 225  , 30 , 35 

111111111111111111111111111111111111111111111
111111111111111000000000000000000000001
              1000000000000000000000001
              1000000000000000000000001
              1000000000000000000000001
              1000000000000000000000001
              100000000000N000000000001
              1000000000000000000000001
              1000000000000000000000001
              1000000000000000000000001
              1000000000000000000000001
              1111111111111111111111111
            





