NO ./texture/path_to_the_south_texturea                                                       
SO    ./texture/path_to_the_south_texturea   
WE ./texture/path_to_the_west_textureC                                    
EA        ./texture/path_to_the_west_textureD
      F 55      ,  11 ,  200
      C 225  , 30 , 35 
111111111111111
1000000000000001
10000111111111111111111111
10000011000000000000010001
10000000000000000000000001
10000011000000000000010001
11101111111011111111110001
110000110000001      10001
100000010000001      10001
100000010000001      10001
10000000000000111111111011111111111
10000001000000100000000000000000001
100000010000001000000000000000000011111
110000110000001001100000000000110010001
111111111111111001000000000000010010001
              1000000000000000000010001
              1000100000000000000110001
              1000000000001000000000001
              1000000000000000000010001
              1000000000000000000010001
              1001000000000000010010001
              1001100000000000110010001
              1000000000000000000010001
              1000000000000000000010001
              1111111111111111111110N01
                                   111