NO ./texture/BRICK_4A.xpm

SO    ./texture/BRICK_4C.xpm         

EA ./texture/BRICK_4D.xpm   

WE        ./texture/BRICK_4E.xpm  

       F 63,13,18        

      C 135  , 206 , 2

111111111111111
1000000000000001
10000111111111111111111111
10000011000000000000010001
10000000000000000000000001
10000011000000000000010001
11101111111011111111110001
110000110000001      10001
100000010000001      10001
100000010000001      10001
10000000000000111111111011111111111   
10000001000000100000000000000000001
1000000100000010W0000000000000000011111
100000110000001001100000000000110010101
111111111111111001000000000000010010011
              1000000000100000000010001
              1010100000010000000110001
              1010000000001000000000001
              1010000000000000000100001
              1010000000000000000010001
              1011000000000001010010001
              1011100010000001010010001
              1010000001000001010010001
              1000000000000000000000001    
              1111111111111111111111111