


















NO ./texture/path_to_the_south_texturea                                                       

SO    ./texture/path_to_the_south_texturea   

      WE ./texture/path_to_the_west_textureC 
                                
                                   
EA        ./texture/path_to_the_west_textureD

      F 55      ,  11 ,  200

      C 225  , 30 , 35 

111111111111111
11111111111111111111
100000010000000111011111
10000111111111111111111111111111111111       
10N00011000000000000010001              
10000010000000000000000001
10000011000000000000010001
11111111111111111111111111
11111111111111111111111111
11111111111111111111111111
11111111111111111111111111



