NO ./texture/BRICK_4A.xpm

SO    ./texture/BRICK_4C.xpm         

EA ./texture/BRICK_4D.xpm   

WE        ./texture/BRICK_4E.xpm  
F 55      ,  11 ,  200
C 225  , 30 , 35 
11111111111111
10000000000001
10000000000001
1N000000000001
10000000000001
10000000000001
10000000000001
10000000000001
10000000000001
10000000000001
10000000000001
10000000000001
11111111111111